1111111111111
10010C1010001
1001001111001
1P001100E0011
1111111111111