1111111111111
10010000000C1
11100111110N1
1P1N11E000001
1111111111111