1111111111111
10000000000C1
10100111110N1
1P1N11E000001
1111111111111