1111111111
1P1000C0E1
101011C111
100000C001
1111111111